###############################
#p    5** *   * 3  *  * * *   #
# # # #*# # #*#*# # # #*#*#*# #
#  s*     ***  *  3   * 4 * * #
# # # # # #*# # #*#*# # # # #*#
#b         x **  *  *         #
# # # # # # # # # #*# #*# # # #
#*  *      *  *      *        #
# # # # #*# # # #*#*# # # # # #
#*    **  *       *           #
# #*# # # # # # #*# # # # # # #
#           *   *  *          #
###############################